##############
#        O   #
#            #
#            #
#      X     #
#            #
#O    ####   #
#            #
#     X ##   #
#            #
#     X     O#
#            #
#     P   X  #
#            #
#     X      #
#        O   #
#   X        #
#        O   #
#      O     #
##############